1111111111
100C100001
1000100101
10001C0101
10000001E1
1010C00101
1C10000101
1010000001
101P000001
1111111111