111111
100C01
111011
10P001
1000E1
111111