111111111111111
100000100000001
1000C00000000C1
100000000011111
100000C00000001
1000000000000E1
111110000000001
100C00000000001
100000000000C01
111111111000001
1P0000000000001
100000011111111
100100000000001
10C100000000001
111111111111111